11111111111111111111111111111111111
11110000011101101010111110000011111
111P000000000CCC0C0C0CCC00111001111
111110000000000CCC1000CC101101CCC11
1100000000C0C0CCC0C0000000000011111
11111111111000000000000000000011101
111100000000000000000000000000E1111
11111111111111111111111111111111111