11111111111111111111111111111111111
111100000111011e1010111110000011111
111P0000e0000CCC0C0C0CCC00111001111
111110000000000CCC1000CC101101CCC11
1100000000CeC0CCC0C0Ce1000000011111
11111111101000000000011001000011101
11110000e0e0000000000000000000E1111
11111111111111111111111111111111111