11111111111111
1000e0000CC001
1P000000000eE1
100C000e000001
11111111111111